R 10000 10000
NO ./textures/multibrick.xpm
SO ./textures/bluestone.xpm
EA ./textures/woodbrick.xpm
WE ./textures/bluegrey.xpm
S ./textures/barrel.xpm
F 255,100,0
C 100,100,255

111111111111111111111111111111111111111111
1000000000002220000000000000011111111112211
10000000000000000000000000000111111110000011
100000000000000000000000000001111110000000011
1111111111110001111111111111111110000000000001
12000001200000000000000000000000000000000000021
10000001000000000000000000000000000000000000021
1000000000000002220000000000011110000000000001
100000000000000222000000000001111110000000001
10000001000000000000000000000111111110000001
1200000120000000000000000000211111111122211
1111111111111111110011111111111111111111111
1111111111111111200002111111111111111111111
1111111111111200000000002111111111111111111
111111111111100000E000000111111111111111111
1111111111111000000000000111111111111111111
1111111111111111111111111111111111111111111
1111111111111111111111111111111111111111111
