R 800 800
NO ./textures/redbrick.xpm
SO ./textures/bluestone.xpm
EA ./textures/eagle.xpm
WE ./textures/greystone.xpm
S ./textures/barrel.xpm
F 255,100,0
C 100,100,255

1111111111111111111111111111
1000000000000000000000000001
1000000000000000002000000001
1000000000000000000000000011
1000000001110111100000000001
1000000001000000100000000001
100000000100N000220010000011
1000000000000000200000000011
1000000000010100200000000001
1111111111111111111111111111
