R 10000 10000
NO ./textures/multibrick.xpm
SO ./textures/bluestone.xpm
EA ./textures/woodbrick.xpm
WE ./textures/bluegrey.xpm
S ./textures/barrel.xpm
F 255,100,0
C 100,100,255

1111111111111111111111111111111111111111111
10000000000022200000000000000111111111122111
100000000000000000000000000001111111100000111
1000000000000000000000000000011111100000000111
11111111111100011111111111111111100000000000011
120000012000000000000000000000000000000000000211
100000010000000000000000000000000000000000000211
100000000000000222000000000001111000000000000111
100000000000000222000000000001111110000000001111
100000010000000000000000000001111111100000011111
120000012000000000000000000021111111112221111111
111111111111111111001111111111111111111111111111
111111111111111120000211111111111111111111111111
111111111111120000000000211111111111111111111111
111111111111100000E0000001111111111111111111111
1111111111111000000000000111111111111111111111
111111111111111111111111111111111111111111111
11111111111111111111111111111111111111111111
