R 1920 1080
NO ./path_to_the_north_texture
SO ./path_to_the_south_texture
EA ./path_to_the_east_texture
WE ./path_to_the_west_texture
S ./path_to_the_sprite_texture
F 255,100,0
C 100,100,255


 1111111111111111111111111111
 1000000000000000000000000001
 1000000000000000000000000001
 1000000000000000000000000001
 10000000000000000000000000011
 100000000000N0000000000000001
 10000000000000000000000000011
 1000000000000000000000000001
 1000000000000000000000000001
 1111111111111111111111111111
