R 500 500
NO ./path_to_the_north_texture
SO ./path_to_the_south_texture
EA ./path_to_the_east_texture
WE ./path_to_the_west_texture
S ./path_to_the_sprite_texture
F 255,100,0
C 100,100,255


 111111111111111111111111111
 1000000000000000000000000001
1000000000000000002000001011001
 1000000000000000000000000001
 1000000001111111100000000001
 10000000010000001000000000001
 100000000100W0002000000000111
 100000000111111110000000001111
 1000000000000000000000000001
 111111111111111111111111111

  111
 10001
  111

 11111
 10001
 11111
