R 10000 10000
NO ./textures/redbrick.xpm
SO ./textures/bluestone.xpm
EA ./textures/eagle.xpm
WE ./textures/greystone.xpm
S ./textures/eagle.xpm
F 255,100,0
C 100,100,255

 111111111111111111111111111
 1000000000000000000000000001
1000000000000000002000001011001
 100000000000000000000000001
 1000000001110111100000000001
 10000000010000001000000000001
 100000000100N0002000100000111
 100000000111011110000000001111
 1000000000010100000000000001
 111111111111111111111111111

  111
 10001
  111

 11111
 10001
 11111
